9 9 9 9 9 9 9 9 9 9 9 9 9 9 9 9 9 9 9 9 9 9 9 9 9 9 9 9 9 9 9 9 9 9 9 9 9 9 9 9 9 9 9 9 9 9 9 9 9 9
9 9 9 9 9 9 9 9 9 9 9 9 9 9 9 9 9 9 9 9 9 9 9 9 9 9 9 9 9 9 9 9 9 9 9 9 9 9 9 9 9 9 9 9 9 9 9 9 9 9
14 14 14 14 14 14 14 14 14 14 14 14 14 14 14 14 14 14 14 14 14 14 14 14 14 14 14 14 14 14 14 14 14 14 14 14 14 14 14 14 14 14 14 14 14 14 14 14 14 14
10 10 10 10 10 10 10 10 10 10 10 10 10 10 10 10 10 10 10 10 10 10 10 10 10 10 10 10 10 10 10 10 10 10 10 10 10 10 10 10 10 10 10 10 10 10 10 10 10 10
11 11 11 11 11 11 11 11 11 11 11 11 11 11 11 11 11 11 11 11 11 11 11 11 11 11 11 11 11 11 11 11 11 11 11 11 11 11 11 11 11 11 11 11 11 11 11 11 11 11
12 12 12 12 12 12 12 12 12 12 12 12 12 12 12 12 12 12 12 12 12 12 12 12 12 12 12 12 12 12 12 12 12 12 12 12 12 12 12 12 12 12 12 12 12 12 12 12 12 12
12 12 12 12 15 12 15 12 15 12 15 12 15 12 15 12 15 12 15 12 15 12 15 12 15 12 15 12 15 12 15 12 15 12 15 12 15 12 15 12 15 12 15 12 15 12 15 12 12 12
52 52 55 12 12 12 12 12 12 12 12 12 12 12 12 12 12 12 12 12 12 12 12 12 12 12 12 12 12 12 12 12 12 12 12 12 12 12 12 12 12 12 12 12 12 12 12 54 52 52
9 9 56 13 13 13 13 13 13 13 13 13 13 13 13 13 13 13 13 13 13 13 13 13 13 13 13 13 13 13 13 13 13 13 13 13 13 13 13 13 13 13 13 13 13 13 13 53 9 9
9 9 16 0 0 6 5 5 5 5 5 7 0 0 0 61 62 63 0 64 66 65 0 0 0 0 0 0 0 0 0 0 0 0 0 0 0 0 0 0 0 0 0 0 0 0 0 18 9 9
9 9 16 0 0 1 1 1 1 1 1 1 0 0 0 60 0 59 0 60 0 67 0 0 0 0 0 0 0 0 0 0 0 0 0 0 0 0 0 0 0 0 0 0 0 0 0 18 9 9
9 9 16 0 0 1 2 1 3 1 2 1 0 0 0 0 0 0 0 0 0 0 0 0 0 0 0 0 0 0 0 0 0 0 0 0 0 0 0 0 0 0 0 0 0 0 0 18 9 9
9 9 16 0 0 1 1 1 4 1 1 1 0 0 0 0 0 0 0 0 0 0 0 0 0 0 0 0 0 0 0 0 0 0 0 0 0 0 0 0 0 0 0 0 0 0 0 18 9 9
9 9 16 0 0 0 0 0 8 0 0 0 0 0 0 0 0 0 0 0 0 0 0 0 0 0 0 0 0 0 0 0 0 0 0 0 0 0 0 0 0 0 0 0 0 0 0 18 9 9
9 9 16 0 8 8 8 8 8 8 8 8 8 8 8 8 8 8 8 8 8 8 8 8 8 8 8 8 8 8 8 8 8 8 8 8 8 8 8 8 8 8 8 8 8 8 0 18 9 9
9 9 16 0 0 0 0 0 8 19 20 21 19 21 20 19 20 19 8 19 20 21 19 21 20 19 20 19 8 19 20 21 19 21 20 19 20 19 8 0 0 0 0 0 0 0 0 18 9 9
9 9 16 0 0 0 0 0 8 21 19 21 20 19 21 20 20 21 8 21 19 21 20 19 21 20 20 21 8 21 19 21 20 19 21 20 20 21 8 0 0 0 0 0 0 0 0 18 9 9
9 9 16 0 0 0 0 0 8 21 20 21 19 20 19 21 19 20 8 21 20 21 19 20 19 21 19 20 8 21 20 21 19 20 19 21 19 20 8 0 0 0 0 0 0 0 0 18 9 9
9 9 16 0 0 0 0 0 8 19 20 21 20 21 20 19 21 20 8 19 20 21 20 21 20 19 21 20 8 19 20 21 20 21 20 19 21 20 8 0 0 0 0 0 0 0 0 18 9 9
9 9 16 0 0 0 0 0 8 21 20 19 20 19 21 20 21 19 8 21 20 19 20 19 21 20 21 19 8 21 20 19 20 19 21 20 21 19 8 0 0 0 0 0 0 0 0 18 9 9
9 9 16 0 0 0 0 0 8 19 21 20 19 19 20 20 19 21 8 19 21 20 19 19 20 20 19 21 8 19 21 20 19 19 20 20 19 21 8 0 0 0 0 0 0 0 0 18 9 9
9 9 16 0 0 0 0 0 8 20 19 20 21 20 21 19 20 21 8 20 19 20 21 20 21 19 20 21 8 20 19 20 21 20 21 19 20 21 8 0 0 0 0 0 0 0 0 18 9 9
9 9 16 0 0 0 0 0 8 19 20 21 19 21 20 21 19 20 8 19 20 21 19 21 20 21 19 20 8 19 20 21 19 21 20 21 19 20 8 0 0 0 0 0 0 0 0 18 9 9
9 9 16 0 0 0 0 0 8 19 19 21 20 21 19 21 21 19 8 19 19 21 20 21 19 21 21 19 8 19 19 21 20 21 19 21 21 19 8 0 0 0 0 0 0 0 0 18 9 9
9 9 16 0 8 8 8 8 8 8 8 8 8 8 8 8 8 8 8 8 8 8 8 8 8 8 8 8 8 8 8 8 8 8 8 8 8 8 8 8 8 8 8 8 8 8 0 18 9 9
9 9 16 0 0 0 0 0 8 19 20 21 19 21 20 19 20 19 8 19 20 21 19 21 20 19 20 19 8 19 20 21 19 21 20 19 20 19 8 0 0 0 0 0 0 0 0 18 9 9
9 9 16 0 0 0 0 0 8 21 19 21 20 19 21 20 20 21 8 21 19 21 20 19 21 20 20 21 8 21 19 21 20 19 21 20 20 21 8 0 0 0 0 0 0 0 0 18 9 9
9 9 16 0 0 0 0 0 8 21 20 21 19 20 19 21 19 20 8 21 20 21 19 20 19 21 19 20 8 21 20 21 19 20 19 21 19 20 8 0 0 0 0 0 0 0 0 18 9 9
9 9 16 0 0 0 0 0 8 19 20 21 20 21 20 19 21 20 8 19 20 21 20 21 20 19 21 20 8 19 20 21 20 21 20 19 21 20 8 0 0 0 0 0 0 0 0 18 9 9
9 9 16 0 0 0 0 0 8 21 20 19 20 19 21 20 21 19 8 21 20 19 20 19 21 20 21 19 8 21 20 19 20 19 21 20 21 19 8 0 0 0 0 0 0 0 0 18 9 9
9 9 16 0 0 0 0 0 8 19 21 20 19 19 20 20 19 21 8 19 21 20 19 19 20 20 19 21 8 19 21 20 19 19 20 20 19 21 8 0 0 0 0 0 0 0 0 18 9 9
9 9 16 0 0 0 0 0 8 20 19 20 21 20 21 19 20 21 8 20 19 20 21 20 21 19 20 21 8 20 19 20 21 20 21 19 20 21 8 0 0 0 0 0 0 0 0 18 9 9
9 9 16 0 0 0 0 0 8 19 20 21 19 21 20 21 19 20 8 19 20 21 19 21 20 21 19 20 8 19 20 21 19 21 20 21 19 20 8 0 0 0 0 0 0 0 0 18 9 9
9 9 16 0 0 0 0 0 8 19 19 21 20 21 19 21 21 19 8 19 19 21 20 21 19 21 21 19 8 19 19 21 20 21 19 21 21 19 8 0 0 0 0 0 0 0 0 18 9 9
9 9 16 0 8 8 8 8 8 8 8 8 8 8 8 8 8 8 8 8 8 8 8 8 8 8 8 8 8 8 8 8 8 8 8 8 8 8 8 8 8 8 8 8 8 8 0 18 9 9
9 9 16 0 0 0 0 0 8 19 20 21 19 21 20 19 20 19 8 19 20 21 19 21 20 19 20 19 8 19 20 21 19 21 20 19 20 19 8 0 0 0 0 0 0 0 0 18 9 9
9 9 16 0 0 0 0 0 8 21 19 21 20 19 21 20 20 21 8 21 19 21 20 19 21 20 20 21 8 21 19 21 20 19 21 20 20 21 8 0 0 0 0 0 0 0 0 18 9 9
9 9 16 0 0 0 0 0 8 21 20 21 19 20 19 21 19 20 8 21 20 21 19 20 19 21 19 20 8 21 20 21 19 20 19 21 19 20 8 0 0 0 0 0 0 0 0 18 9 9
9 9 16 0 0 0 0 0 8 19 20 21 20 21 20 19 21 20 8 19 20 21 20 21 20 19 21 20 8 19 20 21 20 21 20 19 21 20 8 0 0 0 0 0 0 0 0 18 9 9
9 9 16 0 0 0 0 0 8 21 20 19 20 19 21 20 21 19 8 21 20 19 20 19 21 20 21 19 8 21 20 19 20 19 21 20 21 19 8 0 0 0 0 0 0 0 0 18 9 9
9 9 16 0 0 0 0 0 8 19 21 20 19 19 20 20 19 21 8 19 21 20 19 19 20 20 19 21 8 19 21 20 19 19 20 20 19 21 8 0 0 0 0 0 0 0 0 18 9 9
9 9 16 0 0 0 0 0 8 20 19 20 21 20 21 19 20 21 8 20 19 20 21 20 21 19 20 21 8 20 19 20 21 20 21 19 20 21 8 0 0 0 0 0 0 0 0 18 9 9
9 9 16 0 0 0 0 0 8 19 20 21 19 21 20 21 19 20 8 19 20 21 19 21 20 21 19 20 8 19 20 21 19 21 20 21 19 20 8 0 0 0 0 0 0 0 0 18 9 9
9 9 16 0 0 0 0 0 8 19 19 21 20 21 19 21 21 19 8 19 19 21 20 21 19 21 21 19 8 19 19 21 20 21 19 21 21 19 8 0 0 0 0 0 0 0 0 18 9 9
9 9 16 0 8 8 8 8 8 8 8 8 8 8 8 8 8 8 8 8 8 8 8 8 8 8 8 8 8 8 8 8 8 8 8 8 8 8 8 8 8 8 8 8 8 8 0 18 9 9
9 9 16 0 0 0 0 0 8 0 0 0 0 0 0 0 0 0 8 0 0 0 0 0 0 0 0 0 8 0 0 0 0 0 0 0 0 0 8 0 0 0 0 0 0 0 0 18 9 9
9 9 16 0 0 0 0 0 0 0 0 0 0 0 0 0 0 0 0 0 0 0 0 0 0 0 0 0 0 0 0 0 0 0 0 0 0 0 8 0 0 0 0 0 0 0 0 18 9 9
9 9 57 17 17 17 17 17 17 17 17 17 17 17 17 17 17 17 17 17 17 17 17 17 17 17 17 17 17 17 17 17 17 17 17 17 17 17 17 17 17 17 17 17 17 17 17 58 9 9
9 9 9 9 9 9 9 9 9 9 9 9 9 9 9 9 9 9 9 9 9 9 9 9 9 9 9 9 9 9 9 9 9 9 9 9 9 9 9 9 9 9 9 9 9 9 9 9 9 9
9 9 9 9 9 9 9 9 9 9 9 9 9 9 9 9 9 9 9 9 9 9 9 9 9 9 9 9 9 9 9 9 9 9 9 9 9 9 9 9 9 9 9 9 9 9 9 9 9 9

